22222222222222222222222222222222222222222222222222
22222222222222222222222222222222222222222222222222
22221111111111111111111111111111111111110000002222
22221111111111111111111111111111111111100000002222
22221111111111111111111111111111111110000000002222
22221111111111111111111111111111000000000000002222
22221111111111111111100000000000000000000000002222
22221111111100000000000000000000000000000000002222
22220000000000000000000000000000000000000000002222
22220000000000000000000000000000000000000000002222
22220000000000000000000000000000000000000000002222
22220000000000000000000000000000000000000000002222
22220000000000000000000000000000000000000000002222
22220000000000000000000000000000000000000000002222
22220000000000000000000000000000000000000000002222
22220000000000000000000000000000000000000000002222
22220000000000000000000000000000000000000000002222
22220000000000000000000000000000000000000000002222
22220000000000000000000000000000000000000000002222
22220000000000000000000000000000000000000000002222
22220000000000000000000000000000000000000000002222
22220000000000000000000000000000000000000000002222
22220000000000000000000000000000000000000000002222
22220000000000000000000000000000000000000000002222
22220000000000000000000000000000000000000000002222
22220000000000000000000000000000000000000000002222
22220000000000000000000000000000000000000000002222
22220000000000000000000000000000000000000000002222
22220000000000000000000000000000000000000000002222
22220000000000000000000000000000000000000000002222
22220000000000000000000000000000000000000000002222
22220000000000000000000000000000000000000000002222
22220000000000000000000000000000000000000000002222
22220000000000000000000000000000000000000000002222
22220000000000000000000000000000000000000000002222
22220000000000000000000000000000000000000000002222
22220000000000000000000000000000000000000000002222
22220000000000000000000000000000000000000000002222
22220000000000000000000000000000000000000000002222
22220000000000000000000000000000000000000000002222
22220000000000000000000000000000000000000000002222
22220000000000000000000000000000000000000000002222
22220000000000000000000000000000000000000000002222
22220000000000000000000000000000000000000000002222
22220000000000000000000000000000000000000000002222
22220000000000000000000000000000000000000000002222
22220000000000000000000000000000000000000000002222
22220000000000000000000000000000000000000000002222
22222222222222222222222222222222222222222222222222
22222222222222222222222222222222222222222222222222